16 9 6
1 1 1 1 1 1 1 1 1 1 1 1 1 1 1 1
0 0 0 0 1 1 0 0 0 0 0 0 1 1 1 1
0 0 0 0 1 1 0 0 0 0 0 0 1 1 1 1
1 1 0 0 1 1 0 0 1 1 0 0 1 1 1 1
1 1 0 0 1 1 0 0 1 1 0 0 1 1 1 1
1 1 0 0 1 1 0 0 1 1 0 0 1 1 1 1
1 1 0 0 0 0 0 0 1 1 0 0 0 0 0 0
1 1 0 0 0 0 0 0 1 1 0 0 0 0 0 0
1 1 1 1 1 1 1 1 1 1 1 1 1 1 1 1
Target 15 6 1 2 10
NormalSpawner 0 1 2 2 45 90 20
SmallerSpawner 0 1 2 2 30 300 30
TankerSpawner 0 1 2 2 60 600 5
BossSpawner 0 1 2 2 0 900 1
Coins 40